トレーナータイプ	視線ＢＧＭ	戦闘ＢＧＭ	分類
TRTYPE_aroma	mus_dp_eye_lady.mid	mus_dp_ba_train.mid	アロマなおねえさん
TRTYPE_iseki	mus_dp_eye_mount.mid	mus_dp_ba_train.mid	いせきマニア
TRTYPE_interview	mus_dp_eye_fun.mid	mus_dp_ba_train.mid	インタビュアー
TRTYPE_ukiwag	mus_dp_eye_kid.mid	mus_dp_ba_train.mid	うきわガール
TRTYPE_ukiwab	mus_dp_eye_kid.mid	mus_dp_ba_train.mid	うきわボーイ
TRTYPE_aneotouto	mus_dp_eye_sport.mid	mus_dp_ba_train.mid	うみきょうだい
TRTYPE_elitew	mus_dp_eye_elite.mid	mus_dp_ba_train.mid	エリートトレーナー♀
TRTYPE_elitem	mus_dp_eye_elite.mid	mus_dp_ba_train.mid	エリートトレーナー♂
TRTYPE_princess	mus_dp_eye_rich.mid	mus_dp_ba_train.mid	おじょうさま
TRTYPE_sister	mus_dp_eye_lady.mid	mus_dp_ba_train.mid	おとなのおねえさん
TRTYPE_prince	mus_dp_eye_rich.mid	mus_dp_ba_train.mid	おぼっちゃま
TRTYPE_swimmerm	mus_dp_eye_sport.mid	mus_dp_ba_train.mid	かいパンやろう
TRTYPE_karate	mus_dp_eye_fight.mid	mus_dp_ba_train.mid	からておう
TRTYPE_guitarist	mus_dp_eye_fight.mid	mus_dp_ba_train.mid	ギタリスト
TRTYPE_campb	mus_dp_eye_boy.mid	mus_dp_ba_train.mid	キャンプボーイ
TRTYPE_espw	mus_dp_eye_fight.mid	mus_dp_ba_train.mid	サイキッカー♀
TRTYPE_espm	mus_dp_eye_fight.mid	mus_dp_ba_train.mid	サイキッカー♂
TRTYPE_gentle	mus_dp_eye_rich.mid	mus_dp_ba_train.mid	ジェントルマン
TRTYPE_schoolg	mus_dp_eye_girl.mid	mus_dp_ba_train.mid	じゅくがえり♀
TRTYPE_schoolb	mus_dp_eye_boy.mid	mus_dp_ba_train.mid	じゅくがえり♂
TRTYPE_daisukiw	mus_dp_eye_fun.mid	mus_dp_ba_train.mid	だいすきクラブ♀
TRTYPE_daisukim	mus_dp_eye_fun.mid	mus_dp_ba_train.mid	だいすきクラブ♂
TRTYPE_tanpan	mus_dp_eye_boy.mid	mus_dp_ba_train.mid	たんパンこぞう
TRTYPE_fishing	mus_dp_eye_enka.mid	mus_dp_ba_train.mid	つりびと
TRTYPE_dragon	mus_dp_eye_elite.mid	mus_dp_ba_train.mid	ドラゴンつかい
TRTYPE_bird	mus_dp_eye_sport.mid	mus_dp_ba_train.mid	とりつかい
TRTYPE_shinobi	mus_dp_eye_kid.mid	mus_dp_ba_train.mid	にんじゃごっこ
TRTYPE_battleg	mus_dp_eye_fight.mid	mus_dp_ba_train.mid	バトルガール
TRTYPE_parasol	mus_dp_eye_lady.mid	mus_dp_ba_train.mid	パラソルおねえさん
TRTYPE_swimmerw	mus_dp_eye_lady.mid	mus_dp_ba_train.mid	ビキニのおねえさん
TRTYPE_picnicg	mus_dp_eye_girl.mid	mus_dp_ba_train.mid	ピクニックガール
TRTYPE_futago	mus_dp_eye_kid.mid	mus_dp_ba_train.mid	ふたごちゃん
TRTYPE_sailor	mus_dp_eye_enka.mid	mus_dp_ba_train.mid	ふなのり
TRTYPE_collector	mus_dp_eye_mys.mid	mus_dp_ba_train.mid	ポケモンコレクター
TRTYPE_breederw	mus_dp_eye_lady.mid	mus_dp_ba_train.mid	ポケモンブリーダー♀
TRTYPE_breederm	mus_dp_eye_boy.mid	mus_dp_ba_train.mid	ポケモンブリーダー♂
TRTYPE_rangerw	mus_dp_eye_elite.mid	mus_dp_ba_train.mid	ポケモンレンジャー♀
TRTYPE_rangerm	mus_dp_eye_elite.mid	mus_dp_ba_train.mid	ポケモンレンジャー♂
TRTYPE_mini	mus_dp_eye_girl.mid	mus_dp_ba_train.mid	ミニスカート
TRTYPE_mushi	mus_dp_eye_boy.mid	mus_dp_ba_train.mid	むしとりしょうねん
TRTYPE_mount	mus_dp_eye_mount.mid	mus_dp_ba_train.mid	やまおとこ
TRTYPE_lovelove	mus_dp_eye_fun.mid	mus_dp_ba_train.mid	ラブラブカップル
TRTYPE_cyclingm	mus_dp_eye_sport.mid	mus_dp_ba_train.mid	サイクリング♂
TRTYPE_cyclingw	mus_dp_eye_sport.mid	mus_dp_ba_train.mid	サイクリング♀
TRTYPE_gingam	mus_dp_eye_ginga.mid	mus_dp_ba_ginga.mid	ギンガだん♂
TRTYPE_gingaw	mus_dp_eye_ginga.mid	mus_dp_ba_ginga.mid	ギンガだん♀
TRTYPE_gingaleader1	mus_dp_eye_ginga.mid	mus_dp_ba_ginga.mid	ギンガだんかんぶ
TRTYPE_gingaleader2	mus_dp_eye_ginga.mid	mus_dp_ba_ginga.mid	ギンガだんかんぶ
TRTYPE_gingaleader3	mus_dp_eye_ginga.mid	mus_dp_ba_ginga.mid	ギンガだんかんぶ
TRTYPE_madam	mus_dp_eye_rich.mid	mus_dp_ba_train.mid	マダム
TRTYPE_waiter	mus_dp_eye_fun.mid	mus_dp_ba_train.mid	ウエーター
TRTYPE_waitress	mus_dp_eye_fun.mid	mus_dp_ba_train.mid	ウエートレス
TRTYPE_worker	mus_dp_eye_fun.mid	mus_dp_ba_train.mid	さぎょういん
TRTYPE_farmer	mus_dp_eye_mount.mid	mus_dp_ba_train.mid	ぼくじょうおじさん
TRTYPE_cowgirl	mus_dp_eye_mount.mid	mus_dp_ba_train.mid	カウガール
TRTYPE_family	mus_dp_eye_mount.mid	mus_dp_ba_train.mid	ぼくじょうおやこ
TRTYPE_pierrot	mus_dp_eye_fun.mid	mus_dp_ba_train.mid	ピエロ
TRTYPE_idol	mus_dp_eye_girl.mid	mus_dp_ba_train.mid	アイドル
TRTYPE_artist	mus_dp_eye_fun.mid	mus_dp_ba_train.mid	げいじゅつか
TRTYPE_pokegirl	mus_dp_eye_kid.mid	mus_dp_ba_train.mid	ポケモンごっこ♀
TRTYPE_police	mus_dp_eye_fight.mid	mus_dp_ba_train.mid	おまわりさん
TRTYPE_doubleteam	mus_dp_eye_elite.mid	mus_dp_ba_train.mid	ダブルチーム
TRTYPE_skierm	mus_dp_eye_sport.mid	mus_dp_ba_train.mid	スキーヤー♂
TRTYPE_skierw	mus_dp_eye_sport.mid	mus_dp_ba_train.mid	スキーヤー♀
TRTYPE_heads	mus_dp_eye_fight.mid	mus_dp_ba_train.mid	スキンヘッズ
TRTYPE_scientist	mus_dp_eye_mys.mid	mus_dp_ba_train.mid	けんきゅういん♂
TRTYPE_jogger	mus_dp_eye_sport.mid	mus_dp_ba_train.mid	ジョギング♂
TRTYPE_veteran	mus_dp_eye_elite.mid	mus_dp_ba_train.mid	ベテラントレーナー
TRTYPE_cameraman	mus_dp_eye_fun.mid	mus_dp_ba_train.mid	カメラマン
TRTYPE_reporter	mus_dp_eye_fun.mid	mus_dp_ba_train.mid	レポーター
TRTYPE_gambler	mus_dp_eye_rich.mid	mus_dp_ba_train.mid	ギャンブラー
TRTYPE_coldelitew	mus_dp_eye_elite.mid	mus_dp_ba_train.mid	エリートトレーナー♀（厚着）
TRTYPE_coldelitem	mus_dp_eye_elite.mid	mus_dp_ba_train.mid	エリートトレーナー♂（厚着）
TRTYPE_bigfour1	mus_dp_eye_tenno.mid	mus_dp_ba_train.mid	四天王1
TRTYPE_bigfour2	mus_dp_eye_tenno.mid	mus_dp_ba_train.mid	四天王2
TRTYPE_bigfour3	mus_dp_eye_tenno.mid	mus_dp_ba_train.mid	四天王3
TRTYPE_bigfour4	mus_dp_eye_tenno.mid	mus_dp_ba_train.mid	四天王4
TRTYPE_champion	mus_dp_eye_champ.mid	mus_dp_ba_train.mid	チャンピオン
TRTYPE_maid	mus_dp_eye_fun.mid	mus_dp_ba_train.mid	メイド
